SO ./assets/walls/music.png
NO ./assets/walls/music.png
EA ./assets/walls/music.png
WE ./assets/walls/music.png

F 33,32,33
C 68,2,115

                                        11111111111111111111111111
                                        10000000000001000000000001
                                        10000000000010000000000001
                                        10000000000000000000000001
                                        10000000000000000000000001
                                        10000000000100000000000001
                                        10000000000000000000000001
                                        10000000001000000000000001
                                        10000000000000000000000001
                                        10000000001000000000000001
                                        10000000000000000000000001
                                        10000000000000000000000001
                                        10000000000000010000000001
                                        10000000000000000010000001
                                        10000000000000000000000001
1111111111111111111111111111111111111111111121111111111111112111111111111111111111111111111111111111111111
1000000000000000000000000000000000000000100000000000000000100000010000000000000000000000000000000000000001
1000000000000000010000000000000000000000100000000000000000000000010000000000000000000000000000000000000001
1000000000000000000010000000000000000000200000000000S00000000000020000000000000010000000000000000000000001
1000000000000000000100000000000000000000100000001000000000000000010000000000000000010000000000000000000001
1000000000000000000000000000000000000000100000000000000000000000010000000000000000000000000000000000000001
1111111111111111111111111111111111111111111111111111211111111111111111111111111111111111111111111111111111
                                        10000000000000000000000001
                                        10000100000000100000000001
                                        10000010000000000100000001
                                        10000000000000000000000001
                                        10000010000001000010000001
                                        10001000000000000000000001
                                        10000000000000000010000001
                                        10000000100000000000000001
                                        10000000000000000100000001
                                        10000000000001000000000001
                                        10000000000000000000000001
                                        10000000000000000000000001
                                        10000000000000000000000001
                                        10000000000000000000000001
                                        11111111111111111111111111